+ - + - + - + - + - + - + - + - +
|       |                       |
+ - +   +   + - + - + - +   + - +
|       |               |       |
+   + - + - +   + - + - + - +   +
|   |       |   |               |
+   +   +   +   +   + - + - +   +
|       |       |   |           |
+   + - + - + - +   +   + - + - +
|           |       |   |       |
+ - + - + - +   + - + - +   +   +
|               |           |   |
+   + - + - + - +   + - + - +   +
|   |               |           |
+   +   + - + - + - + - + - + - +
|                               |
+ - + - + - + - + - + - + - + - +
