+ - + - + - + - + - + - + - + - + - + - + - + - + - + - + - + - + - + - + - + - + - + - + - + - + - + - + - + - + - + - + - + - +
|                       |                                   |                   |           |                                   |
+   + - + - +   + - +   +   + - + - + - + - + - + - + - +   +   + - + - + - +   + - +   +   +   + - + - +   + - + - + - + - +   +
|       |   |       |       |               |           |   |           |   |       |   |       |           |               |   |
+ - +   +   + - +   + - + - +   + - +   + - +   +   + - +   + - + - +   +   + - +   + - + - + - +   + - + - +   + - + - +   + - +
|           |       |       |       |           |   |       |       |   |       |           |       |           |       |       |
+ - + - + - +   + - +   +   + - + - + - + - +   +   +   + - +   +   +   +   +   + - + - +   +   +   +   + - + - + - +   + - +   +
|               |       |                   |   |   |           |   |       |   |   |       |   |   |   |               |   |   |
+   +   + - + - +   + - + - + - + - + - +   + - +   + - + - + - +   + - + - +   +   +   + - +   + - +   + - + - +   +   +   +   +
|   |   |           |           |       |       |               |           |       |       |       |   |           |       |   |
+   + - +   + - + - +   + - +   +   +   + - +   +   + - + - +   + - + - +   + - +   + - +   + - +   +   +   +   + - + - + - +   +
|       |       |           |   |   |       |   |       |               |       |   |       |   |           |   |       |       |
+   +   + - +   +   + - +   +   +   + - +   +   + - +   +   + - + - +   +   + - +   +   + - +   +   + - + - + - +   +   +   + - +
|   |       |   |       |   |   |   |       |   |       |           |   |   |       |           |   |               |   |       |
+   + - +   +   + - + - +   +   + - +   + - +   +   + - + - + - +   + - +   +   + - + - + - + - + - +   + - + - + - +   + - +   +
|   |       |           |   |       |   |       |           |   |           |                   |       |           |           |
+   +   + - + - + - +   +   + - +   +   +   + - + - + - +   +   + - + - + - + - + - + - + - +   +   + - +   + - +   + - + - +   +
|   |               |   |   |           |   |       |       |           |                   |   |   |   |   |   |       |       |
+   + - + - +   + - +   +   + - + - + - +   +   +   +   + - +   +   +   +   + - + - +   +   +   +   +   +   +   +   + - +   + - +
|           |               |               |   |   |       |   |   |   |   |       |   |   |   |   |       |   |           |   |
+ - + - +   + - + - + - + - +   + - + - + - +   + - + - +   + - +   + - +   +   + - +   +   +   +   +   + - +   + - + - + - +   +
|           |               |       |   |                   |       |       |   |       |   |       |                   |       |
+   + - + - +   + - + - +   +   +   +   +   + - + - + - + - +   + - +   + - +   +   + - + - + - + - + - + - + - + - +   + - +   +
|   |           |       |   |   |   |       |                   |               |                       |   |           |       |
+ - +   + - + - +   +   +   + - +   +   + - + - + - +   + - +   +   + - + - + - + - + - + - +   + - +   +   +   + - + - +   +   +
|       |       |   |               |               |   |   |       |                           |   |       |           |   |   |
+   + - +   +   +   + - + - + - +   + - + - + - +   +   +   + - + - +   + - + - + - + - + - + - +   + - +   + - + - +   +   +   +
|       |   |           |       |   |       |       |       |   |       |       |                   |               |       |   |
+   +   +   + - + - + - +   +   + - +   +   +   + - + - +   +   +   + - + - +   +   +   + - +   + - +   + - + - + - + - + - +   +
|   |   |           |       |           |   |   |       |       |           |       |   |       |       |   |               |   |
+ - +   + - + - +   +   + - + - + - + - +   +   +   +   + - + - +   + - +   +   + - +   + - + - +   + - +   +   +   + - + - +   +
|       |   |       |   |           |       |   |   |           |   |       |       |       |       |       |   |       |       |
+   + - +   +   + - +   + - + - +   +   + - +   +   + - + - +   + - +   + - +   + - + - +   +   + - +   +   +   + - +   +   + - +
|   |       |       |   |       |   |       |       |                   |       |           |       |   |   |   |   |   |       |
+   +   +   + - +   +   +   +   +   + - +   + - + - + - +   + - + - + - +   + - +   + - + - + - +   + - +   +   +   +   + - +   +
|   |   |       |   |       |   |       |               |   |       |   |   |       |                       |       |       |   |
+   + - + - +   +   + - + - +   +   + - + - + - + - +   + - +   +   +   +   +   + - +   + - + - + - + - + - + - +   +   +   +   +
|           |       |   |       |                   |           |   |       |               |       |               |   |   |   |
+   + - +   +   + - +   +   + - + - + - + - +   +   + - + - + - +   +   + - + - + - + - + - +   +   +   + - + - + - +   + - +   +
|       |   |   |       |                   |   |               |   |   |                       |   |           |   |           |
+ - +   +   +   +   + - + - + - + - + - +   + - +   + - + - +   +   + - +   + - + - + - + - + - +   + - + - +   +   + - + - + - +
|       |   |   |       |                   |       |       |   |   |       |           |       |               |               |
+   + - +   +   + - +   +   + - + - + - + - +   + - +   +   +   +   +   + - + - +   +   +   +   + - + - + - + - +   + - + - +   +
|   |       |           |       |               |       |       |       |       |   |   |   |       |                       |   |
+   +   + - + - + - +   + - +   +   + - + - + - +   + - + - + - + - + - +   +   + - +   +   +   +   + - + - + - + - +   +   + - +
|   |       |       |       |   |       |       |       |       |           |       |       |   |       |           |   |       |
+ - + - +   +   + - + - +   +   + - +   +   + - + - +   +   +   +   +   + - + - +   + - +   +   + - +   +   + - +   + - + - +   +
|           |   |           |       |   |           |       |   |   |   |       |       |   |   |   |   |   |       |           |
+   + - + - +   +   + - + - + - +   +   +   +   + - + - + - +   + - +   +   + - + - +   + - +   +   +   +   + - +   +   + - + - +
|       |           |           |       |   |           |   |           |           |           |   |   |       |       |       |
+   +   + - + - + - +   +   +   + - + - +   + - +   +   +   + - + - + - +   + - +   + - + - + - +   +   + - +   + - + - +   +   +
|   |                   |   |   |       |   |   |   |       |           |   |           |           |       |               |   |
+   + - + - + - + - + - +   +   +   + - +   +   +   + - +   +   +   + - +   +   + - +   + - + - +   + - +   + - + - + - +   +   +
|   |           |           |   |               |   |       |   |   |       |       |                   |               |   |   |
+   + - + - +   +   + - + - +   + - + - + - + - +   + - + - +   +   +   + - + - +   + - + - + - + - +   + - + - + - +   + - +   +
|               |           |   |                   |           |               |   |               |               |           |
+ - + - + - +   + - + - +   +   +   + - + - + - +   +   + - + - + - + - + - +   +   +   + - + - +   + - + - + - +   + - + - +   +
|           |   |       |   |   |   |   |           |   |   |               |   |   |       |   |               |       |       |
+   +   + - +   + - +   +   +   +   +   +   + - + - +   +   +   + - + - +   + - +   + - +   +   + - + - + - +   + - + - +   + - +
|   |       |   |       |   |       |               |       |       |               |       |       |           |           |   |
+   + - +   +   +   + - +   + - + - +   + - + - + - + - +   + - +   + - + - + - + - +   + - + - +   +   + - + - +   + - + - +   +
|   |       |   |       |       |       |       |           |   |                   |           |   |               |       |   |
+   +   + - +   + - +   + - +   + - + - +   +   +   + - + - +   + - + - + - + - +   + - + - +   +   + - + - + - + - +   +   +   +
|   |                       |               |                                   |                                       |       |
+ - + - + - + - + - + - + - + - + - + - + - + - + - + - + - + - + - + - + - + - + - + - + - + - + - + - + - + - + - + - + - + - +
